NO ./path_to_the_north_texture
WE ./path_to_the_west_texture        
SO ./path_to_the_south_texture
EA ./path_to_the_east_texture

F 0,0,0
C 4,4,7







                                                    111111111111	
                                                   10000000000001111111111111111111111
                                                   100000000000000000000000000000000001                                                                         
                                                   100000000000011111111110111111111101                                                                         
                                                   10000000000001  111111101111111  101                                                                         
                                 11111111111111111110000000000001 10000000000000001 101                                                                                      
                                100000000000000000000011100000001 10111011111111101 101                                                                              
                                10111101111011110101001 100000001 10111011111111101 101                                                                         
                                101001010010100101010011100000001 10110000000000001 101                                                                             
                                101001010010100101010000000000001 10000111111011101 101                                                                             
                                101101110011100111010000000000001 10000111111011101 101                                                                         
                                100000000000000000010000000000001 10110000000000001 101                                                                         
                                10111111111111111101111011111111  101 111111011111  101                                                                         
                                10100000000000000101  101         101111111101111111101                                                                         
                                 1 11110101111111111110001        100000000000000000001                                                                         
                                      10101000000000000001         1111111111111111111                                                                         
                                      10101011111111010101                                                                         
                                 1 1 110101010000001010101      11111                                                                         
                                101010101111010101011 1 1   1111000001                                                                         
                                10000010100101000001    11110000000001                                                                         
                                11111010101101111111111100000000000001                                                                               
                                10001010100001000000000000000000000001                                                                         
                                10111011111101111101111100000000000001                                                                         
                                10000000000000000001    11110000000001                                                                         
                                1011111011111110111         1111000001                                                                         
                           1    10111110111111101               11111                                                                                    
                          1011111011111110011  1                                                                                 
                          10000000011111100001                                                                                    
                          101111000111110010111111                                                                               
               11111111    1    1000000000000000001                                                                                    
              1000000001        1111110W0111111111                                                                             
              101111111              11011                                       111                         
              101                111111011111111111111                          10001                                       
              101               10000000000000000000001                         10001                                    
              10111111111111111110100000000000000000101                         10001                                                  
              10000000000000000000000000000000000000001                          111                                     
              10111111111111111110000000000000000000001                                                                         
              101               10000000111000000000001                                                                         
              101               100000001 1000000000001                                                                         
              101               10000000111000000000001                                                                         
              10111111111111111110000000000000000000001                                                                         
              10000000000000000000000000000000000000001111                                                                         
               1111111111111111101000000000000000000000001                                                                         
                                100000000000000000000011101                                                                         
                                 110111111111111111101  101                                                                         
                                  1011111111111     1 1110111111111                                                                              
                                 10000000000000111111100000000000001                                                                                 
                                 10000000000000000000000000000000001                                                                         
                                 10000000000000111111100000000000001                                                                         
                                 100000000000001     100000000000001                                                                         
                                  1111111111111       111111111111111111                                                                         
                                                                    11111111                                                                               


            
 

            
 
